20
1,01,30,05,1
1,01,31,05,1
1,01,32,05,1
1,01,33,05,1
1,01,34,05,1
1,10,30,06,1
1,01,31,06,1
1,01,32,06,1
1,01,33,06,1
1,01,34,06,1
1,01,30,07,1
1,01,31,07,1
1,01,32,07,1
1,01,33,07,1
1,01,34,07,1
1,01,30,08,1
1,01,31,08,1
1,01,32,08,1
1,01,33,08,1
1,01,34,08,1